á	á
à	à
ả	ả
ã	ã
ạ	ạ
ấ	ấ
ầ	ầ
ẩ	ẩ
ẫ	ẫ
ậ	ậ
ắ	ắ
ằ	ằ
ẳ	ẳ
ẵ	ẵ
ặ	ặ
é	é
è	è
ẻ	ẻ
ẽ	ẽ
ẹ	ẹ
ế	ế
ề	ề
ể	ể
ễ	ễ
ệ	ệ
í	í
ì	ì
ỉ	ỉ
ĩ	ĩ
ị	ị
ó	ó
ò	ò
ỏ	ỏ
õ	õ
ọ	ọ
ố	ố
ồ	ồ
ổ	ổ
ỗ	ỗ
ộ	ộ
ớ	ớ
ờ	ờ
ở	ở
ỡ	ỡ
ợ	ợ
ú	ú
ù	ù
ủ	ủ
ũ	ũ
ụ	ụ
ứ	ứ
ừ	ừ
ử	ử
ữ	ữ
ự	ự
ý	ý
ỳ	ỳ
ỷ	ỷ
ỹ	ỹ
ỵ	ỵ
